{
    "boardSize": 8,
    "board": [
        1,1,2,2,3,3,1,1,2,2,
        3,3,1,1,2,2,3,3,1,1,
        2,2,3,3,1,1,2,2,3,3,
        1,1,2,2,3,3,1,1,2,2,
        3,3,1,1,2,2,3,3,1,1,
        2,2,3,3,1,1,2,2,3,3,
        1,1,2,2,3,3,1,1,2,2,
        3,3,1,1,2,2,3,3,1,1,
        2,2,3,3,1,1,2,2,3,3,
        1,1,2,2,3,3,1,1,2,2
    ]
}